+------------------+
|                  |
|--------------+   |
|              |   |
|---------   --+   | 
|                  |
|-----   ----------|
|-----   ----------|
| 2                |
|------   ---------|
|                  |
|---------+    $   |
|         |        |
|  --+    +---   +-|
|    |           | |
|    + ----------+-|  
|                  |
|    |--------+ 3  |
|   -+       1|---+|
|                 0|
+------------------+