+------------------+
|            |     |
|-------+    |  $  |
|       |    |     |
|   |   |          |
|   |   +-----+    |
|   |        2|    |
|   +---------+    |
|                  |
|   +--------------|
|   |              |
|   |  1     |     |
|   +--------+     |
|                  |
|   +--------------|
|   |              |
|   |   |   -------|
|   |  3|          |
|   +---+   +      |
|           |     0|
+------------------+
